000000000000000000000000
000000000000000000000000
000000000040000000000000
000000000000000000000000
000000001111111000000000
000400001000021000000000
000000001300001000040000
000000001111111000000000
000000000040000000000000
000000000000000000000000
040000000000400000000000
000000000000000000000000
